********************
********************
********************
____________________
____####____________
____________________
___________######___
___#####____________
____##______________
____________________
____________________
____________________
####________________
____________________
____________________
____________________
____________________
_________###########
____________________
____________________
